1 1 1 1 1 1 1 1 1 1 1 1 1 1 1 1 1 1 1 -1
1 1 1 1 1 1 1 1 1 1 1 1 1 1 1 1 1 1 1 -1
1 1 1 1 1 1 1 1 1 1 1 1 1 1 1 1 1 1 1 -1
1 1 1 1 1 1 1 1 1 1 1 1 1 1 1 1 1 1 1 -1
1 1 1 1 1 1 1 1 1 1 1 1 1 1 1 1 1 1 1 -1
1 1 1 1 1 1 1 1 1 1 1 1 1 1 1 1 1 1 1 -1
1 1 1 1 1 1 1 1 1 1 1 1 1 1 1 1 1 1 1 -1
1 1 1 1 1 1 1 1 1 1 1 1 1 1 1 1 1 1 1 -1
1 1 1 1 1 1 1 1 1 1 1 1 1 1 1 1 1 1 1 -1
1 1 1 1 1 1 1 1 1 1 1 1 1 1 1 1 1 1 1 -1
1 1 1 1 1 1 1 1 1 1 1 1 1 1 1 1 1 1 1 -1
1 1 1 1 1 1 1 1 1 1 1 1 1 1 1 1 1 1 1 -1
1 1 1 1 1 1 1 1 1 1 1 1 1 1 1 1 1 1 1 -1
1 1 1 1 1 1 1 1 1 1 1 1 1 1 1 1 1 1 1 -1
1 1 1 1 1 1 1 1 1 1 1 1 1 1 1 1 1 1 1 -1
-2

10 10 10 10 10 10 10 10 10 10 10 10 10 10 10 10 10 10 10 -1
10 10 10 10 10 10 10 10 10 10 10 10 10 10 10 10 10 10 10 -1
10 10 10 10 10 10 10 10 10 10 10 10 10 10 10 10 10 10 10 -1
10 10 10 10 10 10 10 10 10 10 10 10 10 10 10 10 10 10 10 -1
10 10 10 10 10 10 10 10 10 10 10 10 10 10 10 10 10 10 10 -1
10 10 10 10 10 10 10 10 10 10 10 10 10 10 10 10 10 10 10 -1
10 10 10 10 10 10 10 10 10 10 10 10 10 10 10 10 10 10 10 -1
10 10 10 10 10 10 10 10 10 10 10 10 10 10 10 10 10 10 10 -1
10 10 10 10 10 10 10 10 10 10 10 10 10 10 10 10 10 10 10 -1
10 10 10 10 10 10 10 10 10 10 10 10 10 10 10 10 10 10 10 -1
10 10 10 10 10 10 10 10 10 10 10 10 10 10 10 10 10 10 10 -1
10 10 10 10 10 10 10 10 10 10 10 10 10 10 10 10 10 10 10 -1
10 10 10 10 10 10 10 10 10 10 10 10 10 10 10 10 10 10 10 -1
10 10 10 10 10 10 10 10 10 10 10 10 10 10 10 10 10 10 10 -1
10 10 10 10 10 10 10 10 10 10 10 10 10 10 10 10 10 10 10 -1
-2

10 10 10 10 10 10 10 10 10 10 10 10 10 10 10 10 10 10 10 -1
10 10 10 10 10 10 10 10 10 10 10 10 10 10 10 10 10 10 10 -1
10 10 10 10 10 10 10 10 10 10 10 10 10 10 10 10 10 10 10 -1
10 10 10 10 10 10 10 10 10 10 10 10 10 10 10 10 10 10 10 -1
10 10 10 10 10 10 10 10 10 10 10 10 10 10 10 10 10 10 10 -1
10 10 10 10 10 10 10 10 10 10 10 10 10 10 10 10 10 10 10 -1
10 10 10 10 10 10 10 10 10 10 10 10 10 10 10 10 10 10 10 -1
10 10 10 10 10 10 10 10 10 10 10 10 10 10 10 10 10 10 10 -1
10 10 10 10 10 10 10 10 10 10 10 10 10 10 10 10 10 10 10 -1
10 10 10 10 10 10 10 10 10 10 10 10 10 10 10 10 10 10 10 -1
10 10 10 10 10 10 10 10 10 10 10 10 10 10 10 10 10 10 10 -1
10 10 10 10 10 10 10 10 10 10 10 10 10 10 10 10 10 10 10 -1
10 10 10 10 10 10 10 10 10 10 10 10 10 10 10 10 10 10 10 -1
10 10 10 10 10 10 10 10 10 10 10 10 10 10 10 10 10 10 10 -1
10 10 10 10 10 10 10 10 10 10 10 10 10 10 10 10 10 10 10 -1
-2


2 2 2 2 2 2 2 2 2 2 2 2 2 2 2 2 2 2 2 -1
2 2 2 2 2 2 2 2 2 2 2 2 2 2 2 2 2 2 2 -1
2 2 2 2 2 2 2 2 2 2 2 2 2 2 2 2 2 2 2 -1
2 2 2 2 2 2 2 2 2 2 2 2 2 2 2 2 2 2 2 -1
2 2 2 2 2 2 2 2 2 2 2 2 2 2 2 2 2 2 2 -1
2 2 2 2 2 2 2 2 2 2 2 2 2 2 2 2 2 2 2 -1
2 2 2 2 2 2 2 2 2 2 2 2 2 2 2 2 2 2 2 -1
2 2 2 2 2 2 2 2 2 2 2 2 2 2 2 2 2 2 2 -1
2 2 2 2 2 2 2 2 2 2 2 2 2 2 2 2 2 2 2 -1
2 2 2 2 2 2 2 2 2 2 2 2 2 2 2 2 2 2 2 -1
2 2 2 2 2 2 2 2 2 2 2 2 2 2 2 2 2 2 2 -1
2 2 2 2 2 2 2 2 2 2 2 2 2 2 2 2 2 2 2 -1
2 2 2 2 2 2 2 2 2 2 2 2 2 2 2 2 2 2 2 -1
2 2 2 2 2 2 2 2 2 2 2 2 2 2 2 2 2 2 2 -1
2 2 2 2 2 2 2 2 2 2 2 2 2 2 2 2 2 2 2 -1
-2
0 0 0 0 0 0 0 0 0 0 0 0 0 0 0 0 0 0 0 -1
0 0 0 0 0 0 0 0 0 0 0 0 0 0 0 0 0 0 0 -1
0 0 0 0 0 0 0 0 0 0 0 0 0 0 0 0 0 0 0 -1
0 0 0 5 5 5 5 5 6 6 6 5 5 5 5 5 0 0 0 -1
0 0 0 5 6 6 6 6 6 6 6 6 6 6 6 5 0 0 0 -1
0 0 0 5 6 6 6 6 6 6 6 6 6 6 6 5 0 0 0 -1
0 0 0 5 6 6 6 6 6 6 6 6 6 6 6 5 0 0 0 -1
0 0 0 5 6 6 6 6 6 6 6 6 6 6 6 5 0 0 0 -1
0 0 0 5 6 6 6 6 6 6 6 6 6 6 6 5 0 0 0 -1
0 0 0 5 6 6 6 6 6 6 6 6 6 6 6 5 0 0 0 -1
0 0 0 5 5 5 5 5 5 5 5 5 5 5 5 5 0 0 0 -1
0 0 0 0 0 0 0 0 0 0 0 0 0 0 0 0 0 0 0 -1
0 0 0 0 0 0 0 0 0 0 0 0 0 0 0 0 0 0 0 -1
0 0 0 0 0 0 0 0 0 0 0 0 0 0 0 0 0 0 0 -1
0 0 0 0 0 0 0 0 0 0 0 0 0 0 0 0 0 0 0 -1
-2
0 0 0 0 0 0 0 0 0 0 0 0 0 0 0 0 0 0 0 -1
0 0 0 0 0 0 0 0 0 0 0 0 0 0 0 0 0 0 0 -1
0 0 0 0 0 0 0 0 0 0 0 0 0 0 0 0 0 0 0 -1
0 0 0 5 6 6 6 5 0 0 0 5 6 6 6 5 0 0 0 -1
0 0 0 6 0 0 0 0 0 0 0 0 0 0 0 6 0 0 0 -1
0 0 0 6 0 0 0 0 0 0 0 0 0 0 0 6 0 0 0 -1
0 0 0 6 0 0 0 0 0 0 0 0 0 0 0 6 0 0 0 -1
0 0 0 6 0 0 0 0 0 0 0 0 0 0 0 6 0 0 0 -1
0 0 0 6 0 0 0 0 0 0 0 0 0 0 0 6 0 0 0 -1
0 0 0 6 0 0 0 0 4 8 4 0 0 0 0 6 0 0 0 -1
0 0 0 5 6 6 6 6 6 6 6 6 6 6 6 5 0 0 0 -1
0 0 0 0 0 0 0 0 0 0 0 0 0 0 0 0 0 0 0 -1
0 0 0 0 0 0 0 0 0 0 0 0 0 0 0 0 0 0 0 -1
0 0 0 0 0 0 0 0 0 0 0 0 0 0 0 0 0 0 0 -1
0 0 0 0 0 0 0 0 0 0 0 0 0 0 0 0 0 0 0 -1
-2
0 0 0 0 0 0 0 0 0 0 0 0 0 0 0 0 0 0 0 -1
0 0 0 0 0 0 0 0 0 0 0 0 0 0 0 0 0 0 0 -1
0 0 0 0 0 0 0 0 0 0 0 0 0 0 0 0 0 0 0 -1
0 0 0 5 6 7 6 5 0 0 0 5 6 7 6 5 0 0 0 -1
0 0 0 6 0 0 0 0 0 0 0 0 0 0 0 6 0 0 0 -1
0 0 0 6 0 0 0 0 0 0 0 0 0 0 0 6 0 0 0 -1
0 0 0 7 0 0 0 0 0 0 0 0 0 0 0 7 0 0 0 -1
0 0 0 7 0 0 0 0 0 0 0 0 0 0 0 7 0 0 0 -1
0 0 0 6 0 0 0 0 0 0 0 0 0 0 0 6 0 0 0 -1
0 0 0 6 0 0 0 0 4 4 4 0 0 0 0 6 0 0 0 -1
0 0 0 5 6 6 6 6 6 6 6 6 6 6 6 5 0 0 0 -1
0 0 0 0 0 0 0 0 0 0 0 0 0 0 0 0 0 0 0 -1
0 0 0 0 0 0 0 0 0 0 0 0 0 0 0 0 0 0 0 -1
0 0 0 0 0 0 0 0 0 0 0 0 0 0 0 0 0 0 0 -1
0 0 0 0 0 0 0 0 0 0 0 0 0 0 0 0 0 0 0 -1
-2
0 0 0 0 0 0 0 0 0 0 0 0 0 0 0 0 0 0 0 -1
0 0 0 0 0 0 0 0 0 0 0 0 0 0 0 0 0 0 0 -1
0 0 0 0 0 0 0 0 0 0 0 0 0 0 0 0 0 0 0 -1
0 0 0 5 6 7 6 5 5 5 5 5 6 7 6 5 0 0 0 -1
0 0 0 6 0 0 0 0 0 0 0 0 0 0 0 6 0 0 0 -1
0 0 0 6 0 0 0 0 0 0 0 0 0 0 0 6 0 0 0 -1
0 0 0 7 0 0 0 0 0 0 0 0 0 0 0 7 0 0 0 -1
0 0 0 7 0 0 0 0 0 0 0 0 0 0 0 7 0 0 0 -1
0 0 0 6 0 0 0 0 0 0 0 0 0 0 0 6 0 0 0 -1
0 0 0 6 0 0 0 0 0 0 0 0 0 0 0 6 0 0 0 -1
0 0 0 5 6 6 6 6 6 6 6 6 6 6 6 5 0 0 0 -1
0 0 0 0 0 0 0 0 0 0 0 0 0 0 0 0 0 0 0 -1
0 0 0 0 0 0 0 0 0 0 0 0 0 0 0 0 0 0 0 -1
0 0 0 0 0 0 0 0 0 0 0 0 0 0 0 0 0 0 0 -1
0 0 0 0 0 0 0 0 0 0 0 0 0 0 0 0 0 0 0 -1
-2
0 0 0 0 0 0 0 0 0 0 0 0 0 0 0 0 0 0 0 -1
0 0 0 0 0 0 0 0 0 0 0 0 0 0 0 0 0 0 0 -1
0 0 0 0 0 0 0 0 0 0 0 0 0 0 0 0 0 0 0 -1
0 0 0 5 6 6 6 6 6 6 6 6 6 6 6 5 0 0 0 -1
0 0 0 6 5 0 0 0 0 0 0 0 0 0 5 6 0 0 0 -1
0 0 0 6 0 0 0 0 0 0 0 0 0 0 0 6 0 0 0 -1
0 0 0 6 0 0 0 0 0 0 0 0 0 0 0 6 0 0 0 -1
0 0 0 6 0 0 0 0 0 0 0 0 0 0 0 6 0 0 0 -1
0 0 0 6 0 0 0 0 0 0 0 0 0 0 0 6 0 0 0 -1
0 0 0 6 5 0 0 0 0 0 0 0 0 0 5 6 0 0 0 -1
0 0 0 5 6 6 6 6 6 6 6 6 6 6 6 5 0 0 0 -1
0 0 0 0 0 0 0 0 0 0 0 0 0 0 0 0 0 0 0 -1
0 0 0 0 0 0 0 0 0 0 0 0 0 0 0 0 0 0 0 -1
0 0 0 0 0 0 0 0 0 0 0 0 0 0 0 0 0 0 0 -1
0 0 0 0 0 0 0 0 0 0 0 0 0 0 0 0 0 0 0 -1
-2
0 0 0 0 0 0 0 0 0 0 0 0 0 0 0 0 0 0 0 -1
0 0 0 0 0 0 0 0 0 0 0 0 0 0 0 0 0 0 0 -1
0 0 0 0 0 0 0 0 0 0 0 0 0 0 0 0 0 0 0 -1
0 0 0 5 5 5 5 5 5 5 5 5 5 5 5 5 0 0 0 -1
0 0 0 5 5 6 6 6 6 6 6 6 6 6 5 5 0 0 0 -1
0 0 0 5 6 6 6 6 6 6 6 6 6 6 6 5 0 0 0 -1
0 0 0 5 6 6 6 6 6 6 6 6 6 6 6 5 0 0 0 -1
0 0 0 5 6 6 6 6 6 6 6 6 6 6 6 5 0 0 0 -1
0 0 0 5 6 6 6 6 6 6 6 6 6 6 6 5 0 0 0 -1
0 0 0 5 5 6 6 6 6 6 6 6 6 6 5 5 0 0 0 -1
0 0 0 5 5 5 5 5 5 5 5 5 5 5 5 5 0 0 0 -1
0 0 0 0 0 0 0 0 0 0 0 0 0 0 0 0 0 0 0 -1
0 0 0 0 0 0 0 0 0 0 0 0 0 0 0 0 0 0 0 -1
0 0 0 0 0 0 0 0 0 0 0 0 0 0 0 0 0 0 0 -1
0 0 0 0 0 0 0 0 0 0 0 0 0 0 0 0 0 0 0 -1
-2

0 0 0 0 0 0 0 0 0 0 0 0 0 0 0 0 0 0 0 -1
0 0 0 0 0 0 0 0 0 0 0 0 0 0 0 0 0 0 0 -1
0 0 0 0 0 0 0 0 0 0 0 0 0 0 0 0 0 0 0 -1
0 0 0 0 5 6 6 6 6 6 6 6 6 6 5 0 0 0 0 -1
0 0 0 0 5 0 0 0 0 0 0 0 0 0 5 0 0 0 0 -1
0 0 0 0 5 0 0 0 0 0 0 0 0 0 5 0 0 0 0 -1
0 0 0 0 5 0 0 0 0 0 0 0 0 0 5 0 0 0 0 -1
0 0 0 0 5 0 0 0 0 0 0 0 0 0 5 0 0 0 0 -1
0 0 0 0 5 0 0 0 0 0 0 0 0 0 5 0 0 0 0 -1
0 0 0 0 5 0 0 0 0 0 0 0 0 0 5 0 0 0 0 -1
0 0 0 0 5 6 6 6 6 6 6 6 6 6 5 0 0 0 0 -1
0 0 0 0 0 0 0 0 0 0 0 0 0 0 0 0 0 0 0 -1
0 0 0 0 0 0 0 0 0 0 0 0 0 0 0 0 0 0 0 -1
0 0 0 0 0 0 0 0 0 0 0 0 0 0 0 0 0 0 0 -1
0 0 0 0 0 0 0 0 0 0 0 0 0 0 0 0 0 0 0 -1
-2

0 0 0 0 0 0 0 0 0 0 0 0 0 0 0 0 0 0 0 -1
0 0 0 0 0 0 0 0 0 0 0 0 0 0 0 0 0 0 0 -1
0 0 0 0 0 0 0 0 0 0 0 0 0 0 0 0 0 0 0 -1
0 0 0 0 0 5 6 6 6 6 6 6 6 5 0 0 0 0 0 -1
0 0 0 0 0 5 0 0 0 0 0 0 0 5 0 0 0 0 0 -1
0 0 0 0 0 5 0 0 0 0 0 0 0 5 0 0 0 0 0 -1
0 0 0 0 0 5 0 0 0 0 0 0 0 5 0 0 0 0 0 -1
0 0 0 0 0 5 0 0 0 0 0 0 0 5 0 0 0 0 0 -1
0 0 0 0 0 5 0 0 0 0 0 0 0 5 0 0 0 0 0 -1
0 0 0 0 0 5 0 0 0 0 0 0 0 5 0 0 0 0 0 -1
0 0 0 0 0 5 6 6 6 6 6 6 6 5 0 0 0 0 0 -1
0 0 0 0 0 0 0 0 0 0 0 0 0 0 0 0 0 0 0 -1
0 0 0 0 0 0 0 0 0 0 0 0 0 0 0 0 0 0 0 -1
0 0 0 0 0 0 0 0 0 0 0 0 0 0 0 0 0 0 0 -1
0 0 0 0 0 0 0 0 0 0 0 0 0 0 0 0 0 0 0 -1
-2

0 0 0 0 0 0 0 0 0 0 0 0 0 0 0 0 0 0 0 -1
0 0 0 0 0 0 0 0 0 0 0 0 0 0 0 0 0 0 0 -1
0 0 0 0 0 0 0 0 0 0 0 0 0 0 0 0 0 0 0 -1
0 0 0 0 0 0 5 6 6 6 6 6 5 0 0 0 0 0 0 -1
0 0 0 0 0 0 5 0 0 0 0 0 5 0 0 0 0 0 0 -1
0 0 0 0 0 0 5 0 0 0 0 0 5 0 0 0 0 0 0 -1
0 0 0 0 0 0 5 0 0 0 0 0 5 0 0 0 0 0 0 -1
0 0 0 0 0 0 5 0 0 0 0 0 5 0 0 0 0 0 0 -1
0 0 0 0 0 0 5 0 0 0 0 0 5 0 0 0 0 0 0 -1
0 0 0 0 0 0 5 0 0 0 0 0 5 0 0 0 0 0 0 -1
0 0 0 0 0 0 5 6 6 6 6 6 5 0 0 0 0 0 0 -1
0 0 0 0 0 0 0 0 0 0 0 0 0 0 0 0 0 0 0 -1
0 0 0 0 0 0 0 0 0 0 0 0 0 0 0 0 0 0 0 -1
0 0 0 0 0 0 0 0 0 0 0 0 0 0 0 0 0 0 0 -1
0 0 0 0 0 0 0 0 0 0 0 0 0 0 0 0 0 0 0 -1
-2

0 0 0 0 0 0 0 0 0 0 0 0 0 0 0 0 0 0 0 -1
0 0 0 0 0 0 0 0 0 0 0 0 0 0 0 0 0 0 0 -1
0 0 0 0 0 0 0 0 0 0 0 0 0 0 0 0 0 0 0 -1
0 0 0 0 0 0 0 5 6 6 6 5 0 0 0 0 0 0 0 -1
0 0 0 0 0 0 0 5 0 0 0 5 0 0 0 0 0 0 0 -1
0 0 0 0 0 0 0 5 0 0 0 5 0 0 0 0 0 0 0 -1
0 0 0 0 0 0 0 5 0 0 0 5 0 0 0 0 0 0 0 -1
0 0 0 0 0 0 0 5 0 0 0 5 0 0 0 0 0 0 0 -1
0 0 0 0 0 0 0 5 0 0 0 5 0 0 0 0 0 0 0 -1
0 0 0 0 0 0 0 5 0 0 0 5 0 0 0 0 0 0 0 -1
0 0 0 0 0 0 0 5 6 6 6 5 0 0 0 0 0 0 0 -1
0 0 0 0 0 0 0 0 0 0 0 0 0 0 0 0 0 0 0 -1
0 0 0 0 0 0 0 0 0 0 0 0 0 0 0 0 0 0 0 -1
0 0 0 0 0 0 0 0 0 0 0 0 0 0 0 0 0 0 0 -1
0 0 0 0 0 0 0 0 0 0 0 0 0 0 0 0 0 0 0 -1
-2

0 0 0 0 0 0 0 0 0 0 0 0 0 0 0 0 0 0 0 -1
0 0 0 0 0 0 0 0 0 0 0 0 0 0 0 0 0 0 0 -1
0 0 0 0 0 0 0 0 0 0 0 0 0 0 0 0 0 0 0 -1
0 0 0 0 0 0 0 0 5 5 5 0 0 0 0 0 0 0 0 -1
0 0 0 0 0 0 0 0 5 5 5 0 0 0 0 0 0 0 0 -1
0 0 0 0 0 0 0 0 5 5 5 0 0 0 0 0 0 0 0 -1
0 0 0 0 0 0 0 0 5 5 5 0 0 0 0 0 0 0 0 -1
0 0 0 0 0 0 0 0 5 5 5 0 0 0 0 0 0 0 0 -1
0 0 0 0 0 0 0 0 5 5 5 0 0 0 0 0 0 0 0 -1
0 0 0 0 0 0 0 0 5 5 5 0 0 0 0 0 0 0 0 -1
0 0 0 0 0 0 0 0 5 5 5 0 0 0 0 0 0 0 0 -1
0 0 0 0 0 0 0 0 0 0 0 0 0 0 0 0 0 0 0 -1
0 0 0 0 0 0 0 0 0 0 0 0 0 0 0 0 0 0 0 -1
0 0 0 0 0 0 0 0 0 0 0 0 0 0 0 0 0 0 0 -1
0 0 0 0 0 0 0 0 0 0 0 0 0 0 0 0 0 0 0 -1
-2





